************************************** *
*  *                                   *
*  *                                   *
*  *                                   *
*  *         *                         *
*  *         *  **************         *
*  ***********                *        *
*           *                  *       *
*     * ******                         *
*     *   *                      *     *
*     *   *  *                    *    *
*     *   ** *******               *   *
*     *   *  *     *               *   *
*   ***** *  *  *  ***********     *   *
*            *  *  **        *     *   *
*            *  *   *         *    *   *
*  ***       *  *   *          *   *   *
*  * *********  *   *           ****   *
*  *                                   *
**o*************************************
* **************************************
*  *                                   *
*  *                                   *
*  *                                   *
*  *         *                         *
*  *         *                         *
*  ***********                         *
*  *                                   *
*  *                                   *
*  *         *                         *
*  *         *                         *
*  ***********                         *
*  *                                   *
*  *                                   o
*  *         *                         *
*  *         *                         *
*  ***********                         *
*                                      *
*                                      *
****************************************
****************************************
*                                      *
*                                      *
*                                       
*                                      *
*                                      *
*        * *   * *   o  *     *        *
*       *   * *   *     *   *          *
*       *    *    *  *  * *            *
*       *         *  *  * *            *
*       *         *  *  *   *          *
*       *         *  *  *     *        *
*                                      *
*                                      *
*                                      *
*                                      *
*                                      *
*                                      *
*                                      *
****************************************
